000000000000000000000000000000
011111111011111111011111111111
000100110000011100011111110001
000101111111011010011100000111
100000001110011110011100000111
111100011110011110011100000111
111001111110111110011110011111
110000000000000000000000000111
000000000000000000011111111111
111111111111100111111111111111
111111111000000000111111111111
000000111110000000011111100011
111100000000011111000000000000
